#G######
#      #
#C     #
#      #
#P######