#P######
#     G#
#  C   #
#      #
# ######