##########
# G      #
#        #
#    C   #        
#P       #
##########