##########
#     G  #
#        #
#    C   #        
#P       #
##########