        
# #####
#G    #
# ##  #
# C  ##
# ## #
#   P#
# ####