#########
#      P#
#   C####
###  ####
####    #
###### ##
######G##
#########