#########
#      P#
#   C####
###    ##
###     #
###### ##
######G##
#########